char MAPA[26][26] =
{
    "1111111111111111111111111",
    "1000000001111111000000001",
    "1011111101111111011111101",
    "1011111100000000011111101",
    "1000000001111111000000001",
    "1110111101111111011110111",
    "1000111100001000011110001",
    "1010111111101011111110101",
    "1010000111001001110000101",
    "1011110111011101110111101",
    "1011110100000000010111101",
    "1000110001110111000110001",
    "1110111101110111011110111",
    "1000000001110111000000001",
    "1011111101110111011111101",
    "1011100000000000000011101",
    "1000001111110111111000001",
    "1111101110000000111011111",
    "1111101110111110111011111",
    "1000000000000000000000001",
    "1011101111110111111011101",
    "1000001111110111111000001",
    "1011100000010100000011101",
    "1000001111000001111000001",
    "1111111111111111111111111",
};
